1,4,0,-1;0,4,0,-1;1,4,0,-1;0,4,0,-1;1,4,0,-1;0,4,0,-1;0,4,0,-1;1,4,0,-1;1,4,0,-1;0,4,0,-1;1,4,0,-1;1,4,0,-1;0,4,0,-1;0,4,0,-1;0,4,0,-1;0,4,0,-1;1,4,0,-1;0,4,0,-1;1,4,0,-1;1,4,0,-1;2,5,0,-1;0,3,0,-1;0,3,0,-1;0,3,0,-1;0,3,0,-1;1,3,0,-1;-1,-1,0,-1;-1,-1,0,-1;-1,-1,0,-1;-1,-1,0,-1;-1,-1,0,-1;-1,-1,0,-1;-1,-1,0,-1;-1,-1,0,-1;-1,-1,0,-1;-1,-1,0,-1;-1,-1,0,-1;-1,-1,0,-1;-1,-1,0,-1;-1,-1,0,-1;-1,-1,0,-1;-1,-1,0,-1;

0,3,0,-1;0,3,0,-1;0,3,0,-1;0,3,0,-1;0,3,0,-1;0,3,0,-1;0,3,0,-1;0,3,0,-1;0,3,0,-1;0,3,0,-1;0,3,0,-1;0,3,0,-1;0,3,0,-1;0,3,0,-1;0,3,0,-1;0,3,0,-1;0,3,0,-1;0,3,0,-1;0,3,0,-1;0,3,0,-1;0,3,0,-1;0,3,0,-1;0,3,0,-1;0,3,0,-1;0,3,0,-1;4,3,0,-1;-1,-1,0,-1;-1,-1,0,-1;-1,-1,0,-1;-1,-1,0,-1;-1,-1,0,-1;-1,-1,0,-1;-1,-1,0,-1;-1,-1,0,-1;-1,-1,0,-1;-1,-1,0,-1;-1,-1,0,-1;-1,-1,0,-1;-1,-1,0,-1;-1,-1,0,-1;-1,-1,0,-1;-1,-1,0,-1;

0,3,0,-1;0,3,0,-1;0,3,0,-1;0,3,0,-1;0,3,0,-1;0,3,0,-1;0,3,0,-1;0,3,0,-1;0,3,0,-1;0,3,0,-1;0,3,0,-1;0,3,0,-1;0,3,0,-1;0,3,0,-1;0,3,0,-1;0,3,0,-1;0,3,0,-1;0,3,0,-1;0,3,0,-1;0,3,0,-1;0,3,0,-1;0,3,0,-1;0,3,0,-1;0,3,0,-1;0,3,0,-1;1,3,0,-1;-1,-1,0,-1;-1,-1,0,-1;-1,-1,0,-1;-1,-1,0,-1;-1,-1,0,-1;-1,-1,0,-1;-1,-1,0,-1;0,2,0,-1;0,2,0,-1;-1,-1,0,-1;-1,-1,0,-1;-1,-1,0,-1;-1,-1,0,-1;-1,-1,0,-1;-1,-1,0,-1;-1,-1,0,-1;

0,3,0,-1;0,3,0,-1;0,3,0,-1;0,3,0,-1;0,3,0,-1;0,3,0,-1;0,3,0,-1;0,3,0,-1;0,3,0,-1;0,3,0,-1;0,3,0,-1;3,4,0,-1;3,5,0,-1;3,5,0,-1;3,5,0,-1;3,5,0,-1;1,2,0,-1;0,3,0,-1;0,3,0,-1;0,3,0,-1;0,3,0,-1;0,3,0,-1;0,3,0,-1;0,3,0,-1;0,3,0,-1;2,6,0,-1;0,4,0,-1;1,4,0,-1;0,4,0,-1;0,4,0,-1;1,4,0,-1;0,4,0,-1;0,4,0,-1;6,2,0,-1;0,2,0,-1;0,2,0,-1;0,2,0,-1;0,2,0,-1;0,2,0,-1;0,2,0,-1;0,2,0,-1;0,2,0,-1;

3,5,0,-1;3,5,0,-1;3,5,0,-1;3,5,0,-1;1,2,0,-1;0,3,0,-1;0,3,0,-1;0,3,0,-1;0,3,0,-1;0,3,0,-1;0,3,0,-1;4,4,0,-1;-1,-1,0,-1;-1,-1,0,-1;-1,-1,0,-1;-1,-1,0,-1;2,3,0,-1;0,3,0,-1;0,3,0,-1;0,3,0,-1;0,3,0,-1;0,3,0,-1;0,3,0,-1;0,3,0,-1;0,3,0,-1;0,3,0,-1;0,3,0,-1;0,3,0,-1;0,3,0,-1;0,3,0,-1;0,3,0,-1;0,3,0,-1;0,3,0,-1;4,4,0,-1;0,2,0,-1;0,2,0,-1;0,2,0,-1;0,2,0,-1;0,2,0,-1;0,2,0,-1;0,2,0,-1;0,2,0,-1;
-1,-1,0,-1;-1,-1,0,-1;-1,-1,0,-1;-1,-1,0,-1;2,3,0,-1;0,3,0,-1;0,3,0,-1;0,3,0,-1;0,3,0,-1;0,3,0,-1;0,3,0,-1;1,3,0,-1;-1,-1,0,-1;0,2,0,-1;0,2,0,-1;-1,-1,0,-1;2,3,0,-1;0,3,0,-1;0,3,0,-1;0,3,0,-1;0,3,0,-1;0,3,0,-1;0,3,0,-1;0,3,0,-1;0,3,0,-1;0,3,0,-1;0,3,0,-1;0,3,0,-1;0,3,0,-1;0,3,0,-1;0,3,0,-1;0,3,0,-1;0,3,0,-1;4,4,0,-1;0,2,0,-1;0,2,0,-1;0,2,0,-1;0,2,0,-1;0,2,0,-1;0,2,0,-1;0,2,0,-1;0,2,0,-1;
-1,-1,0,-1;-1,-1,0,-1;-1,-1,0,-1;-1,-1,0,-1;0,5,0,-1;3,5,0,-1;3,5,0,-1;1,2,0,-1;0,3,0,-1;0,3,0,-1;0,3,0,-1;1,3,0,-1;0,2,0,-1;0,2,0,-1;-1,-1,0,-1;-1,-1,0,-1;2,4,0,-1;0,3,0,-1;0,3,0,-1;0,3,0,-1;0,3,0,-1;0,3,0,-1;0,3,0,-1;0,3,0,-1;0,3,0,-1;0,3,0,-1;0,3,0,-1;0,3,0,-1;0,3,0,-1;0,3,0,-1;0,3,0,-1;0,3,0,-1;0,3,0,-1;2,6,0,-1;0,4,0,-1;0,4,0,-1;0,4,0,-1;1,4,0,-1;1,4,0,-1;0,4,0,-1;0,4,0,-1;1,4,0,-1;
-1,-1,0,-1;-1,-1,0,-1;-1,-1,0,-1;-1,-1,0,-1;-1,-1,0,-1;-1,-1,0,-1;-1,-1,0,-1;2,3,0,-1;0,3,0,-1;0,3,0,-1;0,3,0,-1;2,6,0,-1;0,4,0,-1;0,4,0,-1;0,4,0,-1;1,4,0,-1;2,5,0,-1;0,3,0,-1;0,3,0,-1;0,3,0,-1;0,3,0,-1;0,3,0,-1;0,3,0,-1;0,3,0,-1;0,3,0,-1;0,3,0,-1;0,3,0,-1;0,3,0,-1;0,3,0,-1;0,3,0,-1;0,3,0,-1;0,3,0,-1;0,3,0,-1;0,3,0,-1;0,3,0,-1;0,3,0,-1;0,3,0,-1;0,3,0,-1;0,3,0,-1;0,3,0,-1;0,3,0,-1;0,3,0,-1;
-1,-1,0,-1;-1,-1,0,-1;-1,-1,0,-1;-1,-1,0,-1;-1,-1,0,-1;-1,-1,0,-1;-1,-1,0,-1;2,3,0,-1;0,3,0,-1;0,3,0,-1;0,3,0,-1;0,3,0,-1;0,3,0,-1;0,3,0,-1;0,3,0,-1;0,3,0,-1;0,3,0,-1;0,3,0,-1;0,3,0,-1;0,3,0,-1;0,3,0,-1;0,3,0,-1;0,3,0,-1;0,3,0,-1;0,3,0,-1;0,3,0,-1;0,3,0,-1;0,3,0,-1;0,3,0,-1;0,3,0,-1;0,3,0,-1;0,3,0,-1;0,3,0,-1;0,3,0,-1;0,3,0,-1;0,3,0,-1;0,3,0,-1;0,3,0,-1;0,3,0,-1;0,3,0,-1;0,3,0,-1;0,3,0,-1;
-1,-1,0,-1;1,5,0,-1;1,4,0,-1;0,4,0,-1;1,4,0,-1;6,2,0,-1;-1,-1,0,-1;2,4,0,-1;0,3,0,-1;0,3,0,-1;0,3,0,-1;0,3,0,-1;0,3,0,-1;0,3,0,-1;0,3,0,-1;0,3,0,-1;0,3,0,-1;0,3,0,-1;0,3,0,-1;0,3,0,-1;3,4,0,-1;3,5,0,-1;3,5,0,-1;3,5,0,-1;1,2,0,-1;0,3,0,-1;0,3,0,-1;0,3,0,-1;0,3,0,-1;0,3,0,-1;0,3,0,-1;0,3,0,-1;0,3,0,-1;0,3,0,-1;0,3,0,-1;0,3,0,-1;0,3,0,-1;0,3,0,-1;0,3,0,-1;0,3,0,-1;0,3,0,-1;0,3,0,-1;
-1,-1,0,-1;2,4,0,-1;0,3,0,-1;0,3,0,-1;0,3,0,-1;2,6,0,-1;1,4,0,-1;2,5,0,-1;0,3,0,-1;0,3,0,-1;0,3,0,-1;0,3,0,-1;0,3,0,-1;0,3,0,-1;0,3,0,-1;0,3,0,-1;0,3,0,-1;0,3,0,-1;0,3,0,-1;0,3,0,-1;4,3,0,-1;0,2,0,-1;0,2,0,-1;0,2,0,-1;2,4,0,-1;0,3,0,-1;0,3,0,-1;0,3,0,-1;0,3,0,-1;0,3,0,-1;0,3,0,-1;0,3,0,-1;3,4,0,-1;3,5,0,-1;3,5,0,-1;3,5,0,-1;1,2,0,-1;0,3,0,-1;0,3,0,-1;0,3,0,-1;0,3,0,-1;0,3,0,-1;
-1,-1,0,-1;2,3,0,-1;0,3,0,-1;0,3,0,-1;0,3,0,-1;0,3,0,-1;0,3,0,-1;0,3,0,-1;0,3,0,-1;0,3,0,-1;0,3,0,-1;0,3,0,-1;0,3,0,-1;0,3,0,-1;0,3,0,-1;0,3,0,-1;0,3,0,-1;0,3,0,-1;0,3,0,-1;0,3,0,-1;1,3,0,-1;0,2,0,-1;0,2,0,-1;0,2,0,-1;2,4,0,-1;0,3,0,-1;0,3,0,-1;0,3,0,-1;0,3,0,-1;0,3,0,-1;0,3,0,-1;0,3,0,-1;4,4,0,-1;0,2,0,-1;0,2,0,-1;0,2,0,-1;2,3,0,-1;0,3,0,-1;0,3,0,-1;0,3,0,-1;0,3,0,-1;0,3,0,-1;
-1,-1,0,-1;2,3,0,-1;0,3,0,-1;0,3,0,-1;0,3,0,-1;3,4,0,-1;1,2,0,-1;0,3,0,-1;0,3,0,-1;0,3,0,-1;0,3,0,-1;0,3,0,-1;0,3,0,-1;0,3,0,-1;0,3,0,-1;0,3,0,-1;0,3,0,-1;0,3,0,-1;0,3,0,-1;0,3,0,-1;1,3,0,-1;0,2,0,-1;-1,-1,0,-1;0,2,0,-1;2,4,0,-1;0,3,0,-1;0,3,0,-1;0,3,0,-1;0,3,0,-1;0,3,0,-1;0,3,0,-1;0,3,0,-1;4,4,0,-1;0,2,0,-1;0,2,0,-1;0,2,0,-1;2,3,0,-1;0,3,0,-1;0,3,0,-1;0,3,0,-1;3,4,0,-1;3,5,0,-1;
-1,-1,0,-1;2,4,0,-1;0,3,0,-1;0,3,0,-1;0,3,0,-1;4,4,0,-1;2,3,0,-1;0,3,0,-1;0,3,0,-1;0,3,0,-1;3,4,0,-1;3,5,0,-1;1,2,0,-1;0,3,0,-1;0,3,0,-1;0,3,0,-1;0,3,0,-1;0,3,0,-1;0,3,0,-1;0,3,0,-1;1,3,0,-1;-1,-1,0,-1;-1,-1,0,-1;-1,-1,0,-1;2,4,0,-1;0,3,0,-1;0,3,0,-1;0,3,0,-1;0,3,0,-1;0,3,0,-1;0,3,0,-1;0,3,0,-1;2,6,0,-1;1,4,0,-1;0,4,0,-1;1,4,0,-1;2,5,0,-1;0,3,0,-1;0,3,0,-1;0,3,0,-1;4,4,0,-1;0,2,0,-1;
-1,-1,0,-1;0,5,0,-1;3,5,0,-1;3,5,0,-1;3,5,0,-1;4,5,0,-1;2,3,0,-1;0,3,0,-1;0,3,0,-1;0,3,0,-1;1,3,0,-1;-1,-1,0,-1;2,4,0,-1;0,3,0,-1;0,3,0,-1;0,3,0,-1;3,4,0,-1;3,5,0,-1;3,5,0,-1;3,5,0,-1;4,5,0,-1;-1,-1,0,-1;-1,-1,0,-1;-1,-1,0,-1;2,4,0,-1;0,3,0,-1;0,3,0,-1;0,3,0,-1;0,3,0,-1;0,3,0,-1;0,3,0,-1;0,3,0,-1;0,3,0,-1;0,3,0,-1;0,3,0,-1;0,3,0,-1;0,3,0,-1;0,3,0,-1;0,3,0,-1;0,3,0,-1;4,4,0,-1;0,2,0,-1;
-1,-1,0,-1;-1,-1,0,-1;-1,-1,0,-1;-1,-1,0,-1;-1,-1,0,-1;-1,-1,0,-1;2,4,0,-1;0,3,0,-1;0,3,0,-1;0,3,0,-1;2,6,0,-1;1,4,0,-1;2,5,0,-1;0,3,0,-1;0,3,0,-1;0,3,0,-1;1,3,0,-1;0,2,0,-1;0,2,0,-1;0,2,0,-1;-1,-1,0,-1;-1,-1,0,-1;-1,-1,0,-1;-1,-1,0,-1;2,4,0,-1;0,3,0,-1;0,3,0,-1;0,3,0,-1;0,3,0,-1;0,3,0,-1;0,3,0,-1;0,3,0,-1;0,3,0,-1;0,3,0,-1;0,3,0,-1;0,3,0,-1;0,3,0,-1;0,3,0,-1;0,3,0,-1;0,3,0,-1;4,4,0,-1;0,2,0,-1;
-1,-1,0,-1;-1,-1,0,-1;-1,-1,0,-1;-1,-1,0,-1;1,5,0,-1;0,4,0,-1;2,5,0,-1;0,3,0,-1;0,3,0,-1;0,3,0,-1;0,3,0,-1;0,3,0,-1;0,3,0,-1;0,3,0,-1;0,3,0,-1;0,3,0,-1;4,3,0,-1;0,2,0,-1;0,2,0,-1;0,2,0,-1;1,5,0,-1;0,4,0,-1;1,4,0,-1;0,4,0,-1;2,5,0,-1;0,3,0,-1;0,3,0,-1;0,3,0,-1;0,3,0,-1;0,3,0,-1;3,4,0,-1;3,5,0,-1;3,5,0,-1;3,5,0,-1;3,5,0,-1;3,5,0,-1;3,5,0,-1;3,5,0,-1;3,5,0,-1;3,5,0,-1;4,5,0,-1;0,2,0,-1;
-1,-1,0,-1;-1,-1,0,-1;-1,-1,0,-1;-1,-1,0,-1;2,4,0,-1;0,3,0,-1;0,3,0,-1;0,3,0,-1;0,3,0,-1;0,3,0,-1;0,3,0,-1;0,3,0,-1;0,3,0,-1;0,3,0,-1;0,3,0,-1;0,3,0,-1;1,3,0,-1;0,2,0,-1;0,2,0,-1;0,2,0,-1;2,4,0,-1;0,3,0,-1;0,3,0,-1;0,3,0,-1;0,3,0,-1;0,3,0,-1;0,3,0,-1;0,3,0,-1;0,3,0,-1;0,3,0,-1;4,3,0,-1;-1,-1,0,-1;-1,-1,0,-1;-1,-1,0,-1;0,2,0,-1;0,2,0,-1;0,2,0,-1;0,2,0,-1;0,2,0,-1;0,2,0,-1;0,2,0,-1;0,2,0,-1;
-1,-1,0,-1;1,5,0,-1;1,4,0,-1;1,4,0,-1;2,5,0,-1;0,3,0,-1;0,3,0,-1;0,3,0,-1;0,3,0,-1;0,3,0,-1;0,3,0,-1;0,3,0,-1;0,3,0,-1;0,3,0,-1;0,3,0,-1;0,3,0,-1;1,3,0,-1;0,2,0,-1;0,2,0,-1;0,2,0,-1;2,4,0,-1;0,3,0,-1;0,3,0,-1;0,3,0,-1;0,3,0,-1;0,3,0,-1;0,3,0,-1;0,3,0,-1;0,3,0,-1;0,3,0,-1;4,4,0,-1;-1,-1,0,-1;-1,-1,0,-1;-1,-1,0,-1;0,2,0,-1;0,2,0,-1;0,2,0,-1;0,2,0,-1;0,2,0,-1;0,2,0,-1;0,2,0,-1;0,2,0,-1;
-1,-1,0,-1;2,4,0,-1;0,3,0,-1;0,3,0,-1;0,3,0,-1;0,3,0,-1;0,3,0,-1;0,3,0,-1;0,3,0,-1;0,3,0,-1;3,4,0,-1;3,5,0,-1;3,5,0,-1;3,5,0,-1;3,5,0,-1;3,5,0,-1;4,5,0,-1;0,2,0,-1;0,2,0,-1;0,2,0,-1;2,4,0,-1;0,3,0,-1;0,3,0,-1;0,3,0,-1;0,3,0,-1;0,3,0,-1;0,3,0,-1;0,3,0,-1;0,3,0,-1;0,3,0,-1;4,4,0,-1;-1,-1,0,-1;-1,-1,0,-1;-1,-1,0,-1;-1,-1,0,-1;-1,-1,0,-1;0,2,0,-1;-1,-1,0,-1;-1,-1,0,-1;-1,-1,0,-1;-1,-1,0,-1;-1,-1,0,-1;
-1,-1,0,-1;2,3,0,-1;0,3,0,-1;0,3,0,-1;0,3,0,-1;0,3,0,-1;0,3,0,-1;3,4,0,-1;3,5,0,-1;3,5,0,-1;4,5,0,-1;0,2,0,-1;0,2,0,-1;0,2,0,-1;0,2,0,-1;0,2,0,-1;0,2,0,-1;0,2,0,-1;0,2,0,-1;0,2,0,-1;2,4,0,-1;0,3,0,-1;0,3,0,-1;0,3,0,-1;0,3,0,-1;0,3,0,-1;0,3,0,-1;0,3,0,-1;0,3,0,-1;0,3,0,-1;4,3,0,-1;-1,-1,0,-1;-1,-1,0,-1;-1,-1,0,-1;-1,-1,0,-1;-1,-1,0,-1;-1,-1,0,-1;-1,-1,0,-1;-1,-1,0,-1;-1,-1,0,-1;-1,-1,0,-1;-1,-1,0,-1;
-1,-1,0,-1;2,3,0,-1;0,3,0,-1;0,3,0,-1;0,3,0,-1;0,3,0,-1;0,3,0,-1;1,3,0,-1;0,2,0,-1;0,2,0,-1;0,2,0,-1;0,2,0,-1;0,2,0,-1;0,2,0,-1;0,2,0,-1;0,2,0,-1;0,2,0,-1;0,2,0,-1;0,2,0,-1;0,2,0,-1;2,4,0,-1;0,3,0,-1;0,3,0,-1;0,3,0,-1;0,3,0,-1;0,3,0,-1;0,3,0,-1;0,3,0,-1;0,3,0,-1;0,3,0,-1;4,4,0,-1;-1,-1,0,-1;-1,-1,0,-1;-1,-1,0,-1;-1,-1,0,-1;-1,-1,0,-1;-1,-1,0,-1;-1,-1,0,-1;-1,-1,0,-1;-1,-1,0,-1;-1,-1,0,-1;-1,-1,0,-1;
-1,-1,0,-1;2,4,0,-1;0,3,0,-1;0,3,0,-1;0,3,0,-1;0,3,0,-1;0,3,0,-1;1,3,0,-1;0,2,0,-1;0,2,0,-1;0,2,0,-1;0,2,0,-1;0,2,0,-1;0,2,0,-1;0,2,0,-1;0,2,0,-1;0,2,0,-1;0,2,0,-1;0,2,0,-1;0,2,0,-1;2,4,0,-1;0,3,0,-1;0,3,0,-1;0,3,0,-1;0,3,0,-1;0,3,0,-1;0,3,0,-1;0,3,0,-1;0,3,0,-1;0,3,0,-1;4,4,0,-1;-1,-1,0,-1;-1,-1,0,-1;-1,-1,0,-1;-1,-1,0,-1;-1,-1,0,-1;-1,-1,0,-1;-1,-1,0,-1;-1,-1,0,-1;-1,-1,0,-1;-1,-1,0,-1;-1,-1,0,-1;
-1,-1,0,-1;0,5,0,-1;3,5,0,-1;3,5,0,-1;3,5,0,-1;3,5,0,-1;3,5,0,-1;4,5,0,-1;-1,-1,0,-1;-1,-1,0,-1;-1,-1,0,-1;0,2,0,-1;0,2,0,-1;0,2,0,-1;0,2,0,-1;0,2,0,-1;0,2,0,-1;0,2,0,-1;0,2,0,-1;0,2,0,-1;0,5,0,-1;3,5,0,-1;3,5,0,-1;3,5,0,-1;3,5,0,-1;3,5,0,-1;3,5,0,-1;3,5,0,-1;3,5,0,-1;3,5,0,-1;4,5,0,-1;-1,-1,0,-1;-1,-1,0,-1;-1,-1,0,-1;-1,-1,0,-1;-1,-1,0,-1;-1,-1,0,-1;-1,-1,0,-1;-1,-1,0,-1;-1,-1,0,-1;-1,-1,0,-1;-1,-1,0,-1;
-1,-1,0,-1;-1,-1,0,-1;-1,-1,0,-1;-1,-1,0,-1;-1,-1,0,-1;-1,-1,0,-1;-1,-1,0,-1;-1,-1,0,-1;-1,-1,0,-1;-1,-1,0,-1;-1,-1,0,-1;0,2,0,-1;0,2,0,-1;-1,-1,0,-1;-1,-1,0,-1;-1,-1,0,-1;0,2,0,-1;-1,-1,0,-1;-1,-1,0,-1;-1,-1,0,-1;-1,-1,0,-1;-1,-1,0,-1;-1,-1,0,-1;-1,-1,0,-1;-1,-1,0,-1;-1,-1,0,-1;-1,-1,0,-1;-1,-1,0,-1;-1,-1,0,-1;-1,-1,0,-1;-1,-1,0,-1;-1,-1,0,-1;-1,-1,0,-1;-1,-1,0,-1;-1,-1,0,-1;-1,-1,0,-1;-1,-1,0,-1;-1,-1,0,-1;-1,-1,0,-1;-1,-1,0,-1;-1,-1,0,-1;-1,-1,0,-1;
