1,6,0,-1;1,6,0,-1;1,6,0,-1;1,6,0,-1;1,6,0,-1;1,6,0,-1;1,6,0,-1;1,6,0,-1;1,6,0,-1;1,6,0,-1;1,6,0,-1;1,6,0,-1;1,6,0,-1;1,6,0,-1;1,6,0,-1;1,6,0,-1;1,6,0,-1;1,6,0,-1;1,7,0,-1;3,6,0,-1;3,6,0,-1;3,6,0,-1;1,7,0,-1;1,6,0,-1;1,6,0,-1;1,6,0,-1;1,6,0,-1;1,6,0,-1;1,6,0,-1;1,6,0,-1;1,6,0,-1;1,6,0,-1;1,6,0,-1;1,6,0,-1;1,6,0,-1;1,6,0,-1;1,6,0,-1;1,6,0,-1;1,6,0,-1;1,6,0,-1;1,6,0,-1;1,6,0,-1;
1,6,0,-1;
1,6,0,-1;1,6,0,-1;1,6,0,-1;1,6,0,-1;1,6,0,-1;1,6,0,-1;1,6,0,-1;1,6,0,-1;1,6,0,-1;1,6,0,-1;1,6,0,-1;1,6,0,-1;1,6,0,-1;1,6,0,-1;1,6,0,-1;1,6,0,-1;1,6,0,-1;1,7,0,-1;3,6,0,-1;3,6,0,-1;3,6,0,-1;1,7,0,-1;1,6,0,-1;1,6,0,-1;1,6,0,-1;1,6,0,-1;1,6,0,-1;1,6,0,-1;1,6,0,-1;1,6,0,-1;1,6,0,-1;1,6,0,-1;1,6,0,-1;1,6,0,-1;1,6,0,-1;1,6,0,-1;1,6,0,-1;1,6,0,-1;1,6,0,-1;1,6,0,-1;1,6,0,-1;
1,6,0,-1;
1,6,0,-1;1,6,0,-1;1,6,0,-1;1,6,0,-1;1,6,0,-1;1,6,0,-1;1,6,0,-1;1,6,0,-1;1,6,0,-1;1,6,0,-1;1,6,0,-1;1,6,0,-1;1,6,0,-1;1,6,0,-1;1,6,0,-1;1,6,0,-1;1,6,0,-1;1,7,0,-1;3,6,0,-1;3,6,0,-1;3,6,0,-1;1,7,0,-1;1,6,0,-1;1,6,0,-1;1,6,0,-1;1,6,0,-1;1,6,0,-1;1,6,0,-1;1,6,0,-1;1,6,0,-1;1,6,0,-1;1,6,0,-1;1,6,0,-1;1,6,0,-1;1,6,0,-1;1,6,0,-1;1,6,0,-1;1,6,0,-1;1,6,0,-1;1,6,0,-1;1,6,0,-1;
1,6,0,-1;
1,6,0,-1;1,6,0,-1;1,6,0,-1;1,6,0,-1;1,6,0,-1;1,6,0,-1;1,6,0,-1;1,6,0,-1;1,6,0,-1;1,6,0,-1;1,6,0,-1;1,6,0,-1;1,6,0,-1;1,6,0,-1;1,6,0,-1;1,6,0,-1;1,6,0,-1;1,7,0,-1;3,6,0,-1;3,6,0,-1;3,6,0,-1;1,7,0,-1;1,6,0,-1;1,6,0,-1;4,1,1,-1;4,1,1,-1;4,1,1,-1;4,1,1,-1;4,1,1,-1;4,1,1,-1;4,1,1,-1;4,1,1,-1;4,1,1,-1;4,1,1,-1;4,1,1,-1;1,6,0,-1;1,6,0,-1;1,6,0,-1;1,6,0,-1;1,6,0,-1;1,6,0,-1;
1,6,0,-1;
1,6,0,-1;1,7,0,-1;1,7,0,-1;1,7,0,-1;1,7,0,-1;1,7,0,-1;1,7,0,-1;1,7,0,-1;1,7,0,-1;1,7,0,-1;1,7,0,-1;1,7,0,-1;1,7,0,-1;1,7,0,-1;1,7,0,-1;1,6,0,-1;1,6,0,-1;1,7,0,-1;3,6,0,-1;3,6,0,-1;3,6,0,-1;1,7,0,-1;1,6,0,-1;1,6,0,-1;4,1,1,-1;4,1,1,-1;4,1,1,-1;4,1,1,-1;4,1,1,-1;4,1,1,-1;4,1,1,-1;4,1,1,-1;4,1,1,-1;4,1,1,-1;4,1,1,-1;1,6,0,-1;1,6,0,-1;1,6,0,-1;1,6,0,-1;1,6,0,-1;1,6,0,-1;
1,6,0,-1;
1,6,0,-1;1,7,0,-1;1,7,0,-1;1,7,0,-1;1,7,0,-1;1,7,0,-1;1,7,0,-1;1,7,0,-1;1,7,0,-1;1,7,0,-1;1,7,0,-1;1,7,0,-1;1,7,0,-1;1,7,0,-1;1,7,0,-1;1,6,0,-1;1,6,0,-1;1,7,0,-1;3,6,0,-1;3,6,0,-1;3,6,0,-1;1,7,0,-1;1,6,0,-1;1,6,0,-1;4,1,1,-1;4,1,1,-1;4,1,1,-1;4,1,1,-1;4,1,1,-1;4,1,1,-1;4,1,1,-1;4,1,1,-1;4,1,1,-1;4,1,1,-1;4,1,1,-1;1,6,0,-1;1,6,0,-1;1,6,0,-1;1,6,0,-1;1,6,0,-1;1,6,0,-1;
1,6,0,-1;
1,6,0,-1;1,7,0,-1;1,7,0,-1;1,7,0,-1;1,7,0,-1;1,7,0,-1;1,7,0,-1;1,7,0,-1;4,1,1,-1;4,1,1,-1;4,1,1,-1;4,1,1,-1;4,1,1,-1;1,7,0,-1;1,7,0,-1;1,6,0,-1;1,6,0,-1;1,7,0,-1;3,6,0,-1;3,6,0,-1;3,6,0,-1;1,7,0,-1;1,6,0,-1;1,6,0,-1;4,1,1,-1;4,1,1,-1;4,1,1,-1;4,1,1,-1;4,1,1,-1;4,1,1,-1;4,1,1,-1;4,1,1,-1;4,1,1,-1;4,1,1,-1;4,1,1,-1;1,6,0,-1;1,6,0,-1;1,6,0,-1;1,6,0,-1;1,6,0,-1;1,6,0,-1;
1,6,0,-1;
1,6,0,-1;1,7,0,-1;1,7,0,-1;1,7,0,-1;1,7,0,-1;1,7,0,-1;1,7,0,-1;1,7,0,-1;4,1,1,-1;4,1,1,-1;4,1,1,-1;4,1,1,-1;4,1,1,-1;1,7,0,-1;1,7,0,-1;1,6,0,-1;1,6,0,-1;1,7,0,-1;3,6,0,-1;3,6,0,-1;3,6,0,-1;1,7,0,-1;1,6,0,-1;1,6,0,-1;4,1,1,-1;4,1,1,-1;4,1,1,-1;4,1,1,-1;4,1,1,-1;4,1,1,-1;4,1,1,-1;4,1,1,-1;4,1,1,-1;4,1,1,-1;4,1,1,-1;1,6,0,-1;1,6,0,-1;1,6,0,-1;1,6,0,-1;1,6,0,-1;1,6,0,-1;
1,6,0,-1;
1,6,0,-1;1,7,0,-1;1,7,0,-1;1,7,0,-1;1,7,0,-1;1,7,0,-1;1,7,0,-1;1,7,0,-1;4,1,1,-1;4,1,1,-1;4,1,1,-1;4,1,1,-1;4,1,1,-1;1,7,0,-1;1,7,0,-1;1,6,0,-1;1,6,0,-1;1,7,0,-1;3,6,0,-1;3,6,0,-1;3,6,0,-1;1,7,0,-1;1,6,0,-1;1,6,0,-1;4,1,1,-1;4,1,1,-1;4,1,1,-1;11,3,1,-1;11,3,1,-1;5,3,1,-1;11,3,1,-1;11,3,1,-1;4,1,1,-1;4,1,1,-1;4,1,1,-1;1,6,0,-1;1,6,0,-1;1,6,0,-1;1,6,0,-1;1,6,0,-1;1,6,0,-1;
1,6,0,-1;
1,6,0,-1;1,7,0,-1;1,7,0,-1;1,7,0,-1;1,7,0,-1;1,7,0,-1;1,7,0,-1;1,7,0,-1;4,1,1,-1;4,1,1,-1;4,1,1,-1;4,1,1,-1;4,1,1,-1;1,7,0,-1;1,7,0,-1;1,6,0,-1;1,6,0,-1;1,7,0,-1;3,6,0,-1;3,6,0,-1;3,6,0,-1;1,7,0,-1;1,6,0,-1;1,6,0,-1;4,1,1,-1;4,1,1,-1;4,1,1,-1;0,6,0,-1;3,6,0,-1;3,6,0,-1;3,6,0,-1;0,6,0,-1;4,1,1,-1;4,1,1,-1;4,1,1,-1;1,6,0,-1;1,6,0,-1;1,6,0,-1;1,6,0,-1;1,6,0,-1;1,6,0,-1;
1,6,0,-1;
1,6,0,-1;1,7,0,-1;1,7,0,-1;1,7,0,-1;1,7,0,-1;1,7,0,-1;1,7,0,-1;1,7,0,-1;11,3,1,-1;11,3,1,-1;5,3,1,-1;11,3,1,-1;11,3,1,-1;1,7,0,-1;1,7,0,-1;1,6,0,-1;1,6,0,-1;1,7,0,-1;3,6,0,-1;3,6,0,-1;3,6,0,-1;1,7,0,-1;1,6,0,-1;1,6,0,-1;11,3,1,-1;11,3,1,-1;11,3,1,-1;0,6,0,-1;3,6,0,-1;3,6,0,-1;3,6,0,-1;0,6,0,-1;11,3,1,-1;11,3,1,-1;11,3,1,-1;1,6,0,-1;1,6,0,-1;1,6,0,-1;1,6,0,-1;1,6,0,-1;1,6,0,-1;
1,6,0,-1;
1,6,0,-1;1,7,0,-1;1,7,0,-1;1,7,0,-1;1,7,0,-1;1,7,0,-1;1,7,0,-1;1,7,0,-1;3,6,0,-1;3,6,0,-1;3,6,0,-1;3,6,0,-1;3,6,0,-1;1,7,0,-1;1,7,0,-1;1,7,0,-1;1,7,0,-1;1,7,0,-1;3,6,0,-1;3,6,0,-1;3,6,0,-1;1,7,0,-1;1,7,0,-1;1,7,0,-1;1,7,0,-1;1,7,0,-1;1,7,0,-1;1,7,0,-1;3,6,0,-1;3,6,0,-1;3,6,0,-1;1,7,0,-1;1,7,0,-1;1,7,0,-1;1,7,0,-1;1,7,0,-1;1,7,0,-1;1,7,0,-1;1,7,0,-1;1,7,0,-1;1,7,0,-1;
1,6,0,-1;
1,6,0,-1;1,7,0,-1;1,7,0,-1;1,7,0,-1;1,7,0,-1;1,7,0,-1;1,7,0,-1;1,7,0,-1;3,6,0,-1;3,6,0,-1;3,6,0,-1;3,6,0,-1;3,6,0,-1;3,6,0,-1;3,6,0,-1;3,6,0,-1;3,6,0,-1;3,6,0,-1;3,6,0,-1;3,6,0,-1;3,6,0,-1;3,6,0,-1;3,6,0,-1;3,6,0,-1;3,6,0,-1;3,6,0,-1;3,6,0,-1;3,6,0,-1;3,6,0,-1;3,6,0,-1;3,6,0,-1;3,6,0,-1;3,6,0,-1;3,6,0,-1;3,6,0,-1;3,6,0,-1;3,6,0,-1;3,6,0,-1;3,6,0,-1;3,6,0,-1;3,6,0,-1;
1,6,0,-1;
1,6,0,-1;1,7,0,-1;1,7,0,-1;1,7,0,-1;1,7,0,-1;1,7,0,-1;1,7,0,-1;1,7,0,-1;3,6,0,-1;3,6,0,-1;3,6,0,-1;3,6,0,-1;3,6,0,-1;3,6,0,-1;3,6,0,-1;3,6,0,-1;3,6,0,-1;3,6,0,-1;3,6,0,-1;3,6,0,-1;3,6,0,-1;3,6,0,-1;3,6,0,-1;3,6,0,-1;3,6,0,-1;3,6,0,-1;3,6,0,-1;3,6,0,-1;3,6,0,-1;3,6,0,-1;3,6,0,-1;3,6,0,-1;3,6,0,-1;3,6,0,-1;3,6,0,-1;3,6,0,-1;3,6,0,-1;3,6,0,-1;3,6,0,-1;3,6,0,-1;3,6,0,-1;
1,6,0,-1;
1,6,0,-1;1,7,0,-1;1,7,0,-1;1,7,0,-1;1,7,0,-1;1,7,0,-1;1,7,0,-1;1,7,0,-1;3,6,0,-1;3,6,0,-1;3,6,0,-1;3,6,0,-1;3,6,0,-1;3,6,0,-1;3,6,0,-1;3,6,0,-1;3,6,0,-1;3,6,0,-1;3,6,0,-1;3,6,0,-1;3,6,0,-1;3,6,0,-1;3,6,0,-1;3,6,0,-1;3,6,0,-1;3,6,0,-1;3,6,0,-1;3,6,0,-1;3,6,0,-1;3,6,0,-1;3,6,0,-1;3,6,0,-1;3,6,0,-1;3,6,0,-1;3,6,0,-1;3,6,0,-1;3,6,0,-1;3,6,0,-1;3,6,0,-1;3,6,0,-1;3,6,0,-1;
1,6,0,-1;
1,6,0,-1;1,7,0,-1;1,7,0,-1;1,7,0,-1;1,7,0,-1;1,7,0,-1;1,7,0,-1;1,7,0,-1;1,7,0,-1;1,7,0,-1;3,6,0,-1;3,6,0,-1;1,7,0,-1;1,7,0,-1;1,7,0,-1;3,6,0,-1;3,6,0,-1;3,6,0,-1;1,7,0,-1;1,7,0,-1;1,7,0,-1;3,6,0,-1;3,6,0,-1;3,6,0,-1;1,7,0,-1;1,7,0,-1;1,7,0,-1;1,6,0,-1;1,6,0,-1;1,6,0,-1;1,6,0,-1;1,6,0,-1;1,6,0,-1;1,6,0,-1;1,6,0,-1;1,6,0,-1;1,6,0,-1;1,6,0,-1;1,6,0,-1;1,6,0,-1;1,6,0,-1;
1,6,0,-1;
1,6,0,-1;4,1,1,-1;4,1,1,-1;4,1,1,-1;4,1,1,-1;4,1,1,-1;4,1,1,-1;4,1,1,-1;1,7,0,-1;1,7,0,-1;3,6,0,-1;3,6,0,-1;1,7,0,-1;1,7,0,-1;4,1,1,-1;4,1,1,-1;4,1,1,-1;4,1,1,-1;4,1,1,-1;1,7,0,-1;4,1,1,-1;4,1,1,-1;4,1,1,-1;4,1,1,-1;4,1,1,-1;1,7,0,-1;1,7,0,-1;1,6,0,-1;1,6,0,-1;1,6,0,-1;1,6,0,-1;1,6,0,-1;1,6,0,-1;1,6,0,-1;1,6,0,-1;1,6,0,-1;1,6,0,-1;1,6,0,-1;1,6,0,-1;1,6,0,-1;1,6,0,-1;
1,6,0,-1;
1,6,0,-1;4,1,1,-1;4,1,1,-1;4,1,1,-1;4,1,1,-1;4,1,1,-1;4,1,1,-1;4,1,1,-1;1,7,0,-1;1,7,0,-1;3,6,0,-1;3,6,0,-1;1,7,0,-1;1,7,0,-1;4,1,1,-1;4,1,1,-1;4,1,1,-1;4,1,1,-1;4,1,1,-1;1,7,0,-1;4,1,1,-1;4,1,1,-1;4,1,1,-1;4,1,1,-1;4,1,1,-1;1,7,0,-1;1,7,0,-1;1,6,0,-1;1,6,0,-1;1,6,0,-1;1,6,0,-1;1,6,0,-1;1,6,0,-1;1,6,0,-1;1,6,0,-1;1,6,0,-1;1,6,0,-1;1,6,0,-1;1,6,0,-1;1,6,0,-1;1,6,0,-1;
1,6,0,-1;
1,6,0,-1;4,1,1,-1;4,1,1,-1;4,1,1,-1;4,1,1,-1;4,1,1,-1;4,1,1,-1;4,1,1,-1;3,6,0,-1;3,6,0,-1;3,6,0,-1;3,6,0,-1;1,7,0,-1;1,7,0,-1;4,1,1,-1;4,1,1,-1;4,1,1,-1;4,1,1,-1;4,1,1,-1;1,7,0,-1;4,1,1,-1;4,1,1,-1;4,1,1,-1;4,1,1,-1;4,1,1,-1;1,7,0,-1;1,7,0,-1;1,6,0,-1;1,6,0,-1;1,6,0,-1;1,6,0,-1;1,6,0,-1;1,6,0,-1;1,6,0,-1;1,6,0,-1;1,6,0,-1;1,6,0,-1;1,6,0,-1;1,6,0,-1;1,6,0,-1;1,6,0,-1;
1,6,0,-1;
1,6,0,-1;4,1,1,-1;4,1,1,-1;4,1,1,-1;4,1,1,-1;4,1,1,-1;4,1,1,-1;4,1,1,-1;3,6,0,-1;3,6,0,-1;3,6,0,-1;3,6,0,-1;1,7,0,-1;1,7,0,-1;11,3,1,-1;11,3,1,-1;11,3,1,-1;11,3,1,-1;11,3,1,-1;1,7,0,-1;11,3,1,-1;11,3,1,-1;11,3,1,-1;11,3,1,-1;11,3,1,-1;1,7,0,-1;1,7,0,-1;1,6,0,-1;1,6,0,-1;1,6,0,-1;1,6,0,-1;1,6,0,-1;1,6,0,-1;1,6,0,-1;1,6,0,-1;1,6,0,-1;1,6,0,-1;1,6,0,-1;1,6,0,-1;1,6,0,-1;1,6,0,-1;
1,6,0,-1;
1,6,0,-1;4,1,1,-1;4,1,1,-1;4,1,1,-1;4,1,1,-1;4,1,1,-1;11,3,1,-1;11,3,1,-1;1,7,0,-1;1,7,0,-1;1,7,0,-1;1,7,0,-1;1,7,0,-1;1,7,0,-1;1,7,0,-1;1,7,0,-1;1,7,0,-1;1,7,0,-1;1,7,0,-1;1,7,0,-1;1,7,0,-1;1,7,0,-1;1,7,0,-1;1,7,0,-1;1,7,0,-1;1,7,0,-1;1,7,0,-1;1,6,0,-1;1,6,0,-1;1,6,0,-1;1,6,0,-1;1,6,0,-1;1,6,0,-1;1,6,0,-1;1,6,0,-1;1,6,0,-1;1,6,0,-1;1,6,0,-1;1,6,0,-1;1,6,0,-1;1,6,0,-1;
1,6,0,-1;
1,6,0,-1;4,1,1,-1;4,1,1,-1;4,1,1,-1;4,1,1,-1;4,1,1,-1;0,6,0,-1;0,6,0,-1;1,7,0,-1;1,7,0,-1;1,7,0,-1;1,7,0,-1;1,7,0,-1;1,7,0,-1;1,7,0,-1;1,7,0,-1;1,7,0,-1;1,7,0,-1;1,7,0,-1;1,7,0,-1;1,7,0,-1;1,7,0,-1;1,7,0,-1;1,7,0,-1;1,7,0,-1;1,7,0,-1;1,7,0,-1;1,6,0,-1;1,6,0,-1;1,6,0,-1;1,6,0,-1;1,6,0,-1;1,6,0,-1;1,6,0,-1;1,6,0,-1;1,6,0,-1;1,6,0,-1;1,6,0,-1;1,6,0,-1;1,6,0,-1;1,6,0,-1;
1,6,0,-1;
1,6,0,-1;11,3,1,-1;11,3,1,-1;11,3,1,-1;11,3,1,-1;11,3,1,-1;0,6,0,-1;0,6,0,-1;1,7,0,-1;1,7,0,-1;1,7,0,-1;1,7,0,-1;1,7,0,-1;1,7,0,-1;1,7,0,-1;1,7,0,-1;1,7,0,-1;1,7,0,-1;1,7,0,-1;1,7,0,-1;1,7,0,-1;1,7,0,-1;1,7,0,-1;1,7,0,-1;1,7,0,-1;1,7,0,-1;1,7,0,-1;1,6,0,-1;1,6,0,-1;1,6,0,-1;1,6,0,-1;1,6,0,-1;1,6,0,-1;1,6,0,-1;1,6,0,-1;1,6,0,-1;1,6,0,-1;1,6,0,-1;1,6,0,-1;1,6,0,-1;1,6,0,-1;
1,6,0,-1;
1,6,0,-1;1,6,0,-1;1,6,0,-1;1,6,0,-1;1,6,0,-1;1,6,0,-1;1,6,0,-1;1,6,0,-1;1,6,0,-1;1,6,0,-1;1,6,0,-1;1,6,0,-1;1,6,0,-1;1,6,0,-1;1,6,0,-1;1,6,0,-1;1,6,0,-1;1,6,0,-1;1,6,0,-1;1,6,0,-1;1,6,0,-1;1,6,0,-1;1,6,0,-1;1,6,0,-1;1,6,0,-1;1,6,0,-1;1,6,0,-1;1,6,0,-1;1,6,0,-1;1,6,0,-1;1,6,0,-1;1,6,0,-1;1,6,0,-1;1,6,0,-1;1,6,0,-1;1,6,0,-1;1,6,0,-1;1,6,0,-1;1,6,0,-1;1,6,0,-1;1,6,0,-1;
1,6,0,-1;
1,6,0,-1;1,6,0,-1;1,6,0,-1;1,6,0,-1;1,6,0,-1;1,6,0,-1;1,6,0,-1;1,6,0,-1;1,6,0,-1;1,6,0,-1;1,6,0,-1;1,6,0,-1;1,6,0,-1;1,6,0,-1;1,6,0,-1;1,6,0,-1;1,6,0,-1;1,6,0,-1;1,6,0,-1;1,6,0,-1;1,6,0,-1;1,6,0,-1;1,6,0,-1;1,6,0,-1;1,6,0,-1;1,6,0,-1;1,6,0,-1;1,6,0,-1;1,6,0,-1;1,6,0,-1;1,6,0,-1;1,6,0,-1;1,6,0,-1;1,6,0,-1;1,6,0,-1;1,6,0,-1;1,6,0,-1;1,6,0,-1;1,6,0,-1;1,6,0,-1;1,6,0,-1